0000000000000000000000000
0000000000000000000030004
0000000000111110000111111
00000000000000000000
1100300000000000000300000
0111111000000000011111000
0000000011100000000000000
0000000000000000000000000
0000000000000000000000000
0000000000001111100000600
0000000060000000000000000
0000000000000000000011111
0000000111100000000000000
0000000000000000000000000
00000000000000001000000000
0001111000000001111000000
20000000000111111111000
1111111111111111111111111
1111111111111111111111111
