000000000000
000000011000
00000000000011
001110000000
00000000000
00000000111111
000000000000
000001110000
000111000000
111000000000
